XXXXXXXXXXXXXXXXXXXXXXXXXXXXXXXXXXXXXXXXX
XOOOOOXOXOOOXOOOXOOOOOXOOOOOOOXOXOOOXOXOX
XOXXXOXOXXXOXXXOXXXOXXXXXOXXXXXOXXXOXOXOX
XOXOOOOOXOXOXOXOXOXOXOXOXOXOOOXOXOXOOOXOX
XXXXXXXOXOXOXOXOXOXOXOXOXOXOXXXOXOXXXOXOX
XOXOXOOOOOOOXOOOOOOOXOXOOOOOOOOOXOXOXOXOX
XOXOXXXXXXXOXOXOXXXOXOXOXXXXXXXXXOXOXOXOX
XOXOXOOOXOXOXOXOXOOOOOOOOOXOXOXOOOXOOOXOX
XOXOXXXOXOXOXXXXXXXXXXXOXXXOXOXOXXXXXOXOX
XOOOXOXOXOOOOOXOOOOOOOXOOOOOOOXOXOXOXOOOX
XXXOXOXOXOXXXOXXXXXXXOXOXXXXXXXOXOXOXXXOX
XOXOXOXOXOXOOOOOOOOOOOOOOOXOOOXOXOOOXOOOX
XOXOXOXOXXXXXXXOXXXXXXXOXXXOXXXOXOXXXOXXX
XOXOXOOOOOXOXOXOXOOOOOOOOOXOXOOOOOOOOOOOX
XOXOXXXOXXXOXOXXXOXXXOXXXXXOXOXXXXXXXXXOX
XOOOOOXOXOXOOOXOOOXOOOXOXOXOXOXOOOOOOOXOX
XXXOXXXOXOXXXOXXXXXXXOXOXOXOXOXOXOXXXOXXX
XOOOOOOOOOXOOOXOXOXOOOXOXOXOXOOOXOOOXOOOX
XXXOXXXXXOXXXOXOXOXXXOXOXOXOXOXXXXXXXXXXX
XOOOOOXOOOXOXOOOOOXOXOOOOOOOOOOOXOXOXOOOX
XOXOXXXXXOXOXXXXXOXOXOXOXXXXXOXOXOXOXOXXX
XOXOXOOOOOXOOOXOOOOOOOXOOOOOXOXOOOOOXOXOX
XXXXXXXXXOXXXOXXXXXXXOXXXXXOXOXXXXXXXOXOX
XOOOOOOOOOOOOOOOOOOOOOXOOOXOXOOOOOOOOOOOX
XOXXXOXOXXXXXXXXXXXXXOXOXXXXXXXOXXXXXOXXX
XOXOOOXOXOOOOOOOOOOOOOXOOOOOOOXOXOOOXOOOX
XOXXXXXXXOXXXOXXXXXOXOXOXOXXXXXOXOXXXXXXX
XOXOOOOOOOXOOOXOOOOOXOOOXOXOXOXOXOXOXOXOX
XOXXXXXXXXXOXOXXXXXOXOXOXXXOXOXOXOXOXOXOX
XOXOOOOOOOOOXOXOOOOOXOXOOOOOOOXOOOOOOOOOX
XXXXXXXOXXXXXXXXXOXOXOXOXXXXXXXXXXXOXXXXX
XOOOOOOOXOOOOOOOOOXOXOXOOOOOXOOOXOXOOOOOX
XXXXXXXXXXXOXOXOXOXOXOXOXOXXXXXOXOXXXOXOX
XOOOXOOOOOOOXOXOXOXOXOXOXOOOOOOOOOOOXOXOX
XOXXXXXXXOXXXXXXXOXOXOXOXXXOXXXXXXXOXOXOX
XOOOXOXOOOXOOOOOOOXOXOXOOOXOOOOOOOXOXOXOX
XXXOXOXOXOXXXXXOXOXXXXXOXXXOXXXXXOXOXOXOX
XOOOOOOOXOXOOOOOXOXOOOOOOOXOOOOOXOXOXOXOX
XOXXXOXXXOXXXXXOXOXOXOXOXXXOXOXXXOXXXOXOX
XOXOOOXOOOXOOOOOXOXOXOXOOOXOXOOOXOOOXOXOX
XXXXXXXXXXXXXXXXXXXXXXXXXXXXXXXXXXXXXXXXX
