S= 3
XXXXXXXXXXXXXXXXXXXXXXXXXXXXXXXXXXXXXXXXXXXXXXXXXXXXXXXXXXXXX
XOOOOOOOXOOOOOOOOOOOOOOOXOOOOOOOXOOOXOOOXOOOOOOOOOOOOOOOOOOOX
XOOOOOOOXOOOOOOOOOOOOOOOXOOOOOOOXOOOXOOOXOOOOOOOOOOOOOOOOOOOX
XOOOOOOOXOOOOOOOOOOOOOOOXOOOOOOOXOOOXOOOXOOOOOOOOOOOOOOOOOOOX
XXXXXOOOXXXXXXXXXOOOXXXXXOOOXXXXXOOOXOOOXOOOXXXXXXXXXXXXXXXXX
XOOOXOOOOOOOXOOOXOOOOOOOXOOOXOOOOOOOXOOOXOOOOOOOXOOOOOOOOOOOX
XOOOXOOOOOOOXOOOXOOOOOOOXOOOXOOOOOOOXOOOXOOOOOOOXOOOOOOOOOOOX
XOOOXOOOOOOOXOOOXOOOOOOOXOOOXOOOOOOOXOOOXOOOOOOOXOOOOOOOOOOOX
XOOOXXXXXOOOXOOOXOOOXXXXXOOOXOOOXXXXXOOOXOOOXXXXXOOOXXXXXXXXX
XOOOOOOOOOOOOOOOXOOOXOOOXOOOXOOOXOOOOOOOOOOOOOOOOOOOOOOOXOOOX
XOOOOOOOOOOOOOOOXOOOXOOOXOOOXOOOXOOOOOOOOOOOOOOOOOOOOOOOXOOOX
XOOOOOOOOOOOOOOOXOOOXOOOXOOOXOOOXOOOOOOOOOOOOOOOOOOOOOOOXOOOX
XXXXXXXXXXXXXOOOXOOOXOOOXOOOXOOOXXXXXOOOXXXXXXXXXXXXXXXXXOOOX
XOOOXOOOOOOOXOOOOOOOXOOOOOOOOOOOOOOOXOOOOOOOXOOOXOOOXOOOXOOOX
XOOOXOOOOOOOXOOOOOOOXOOOOOOOOOOOOOOOXOOOOOOOXOOOXOOOXOOOXOOOX
XOOOXOOOOOOOXOOOOOOOXOOOOOOOOOOOOOOOXOOOOOOOXOOOXOOOXOOOXOOOX
XOOOXXXXXOOOXXXXXOOOXOOOXXXXXXXXXOOOXOOOXXXXXOOOXOOOXOOOXOOOX
XOOOXOOOOOOOXOOOOOOOXOOOXOOOXOOOXOOOXOOOXOOOOOOOOOOOOOOOXOOOX
XOOOXOOOOOOOXOOOOOOOXOOOXOOOXOOOXOOOXOOOXOOOOOOOOOOOOOOOXOOOX
XOOOXOOOOOOOXOOOOOOOXOOOXOOOXOOOXOOOXOOOXOOOOOOOOOOOOOOOXOOOX
XOOOXXXXXOOOXXXXXOOOXOOOXOOOXOOOXXXXXOOOXOOOXXXXXXXXXXXXXOOOX
XOOOOOOOXOOOXOOOOOOOOOOOXOOOXOOOOOOOXOOOXOOOOOOOOOOOXOOOOOOOX
XOOOOOOOXOOOXOOOOOOOOOOOXOOOXOOOOOOOXOOOXOOOOOOOOOOOXOOOOOOOX
XOOOOOOOXOOOXOOOOOOOOOOOXOOOXOOOOOOOXOOOXOOOOOOOOOOOXOOOOOOOX
XOOOXXXXXOOOXXXXXOOOXXXXXOOOXOOOXXXXXOOOXOOOXXXXXXXXXOOOXXXXX
XOOOXOOOXOOOOOOOXOOOXOOOXOOOXOOOOOOOXOOOXOOOOOOOXOOOOOOOOOOOX
XOOOXOOOXOOOOOOOXOOOXOOOXOOOXOOOOOOOXOOOXOOOOOOOXOOOOOOOOOOOX
XOOOXOOOXOOOOOOOXOOOXOOOXOOOXOOOOOOOXOOOXOOOOOOOXOOOOOOOOOOOX
XOOOXOOOXXXXXOOOXOOOXOOOXOOOXOOOXXXXXOOOXOOOXXXXXOOOXXXXXXXXX
XOOOXOOOXOOOOOOOXOOOOOOOXOOOXOOOXOOOXOOOOOOOXOOOXOOOXOOOOOOOX
XOOOXOOOXOOOOOOOXOOOOOOOXOOOXOOOXOOOXOOOOOOOXOOOXOOOXOOOOOOOX
XOOOXOOOXOOOOOOOXOOOOOOOXOOOXOOOXOOOXOOOOOOOXOOOXOOOXOOOOOOOX
XOOOXOOOXXXXXOOOXXXXXOOOXOOOXOOOXOOOXOOOXXXXXOOOXOOOXOOOXXXXX
XOOOXOOOXOOOXOOOOOOOOOOOXOOOOOOOXOOOOOOOXOOOXOOOOOOOXOOOXOOOX
XOOOXOOOXOOOXOOOOOOOOOOOXOOOOOOOXOOOOOOOXOOOXOOOOOOOXOOOXOOOX
XOOOXOOOXOOOXOOOOOOOOOOOXOOOOOOOXOOOOOOOXOOOXOOOOOOOXOOOXOOOX
XOOOXOOOXOOOXXXXXOOOXXXXXOOOXXXXXOOOXXXXXOOOXOOOXXXXXOOOXOOOX
XOOOOOOOXOOOXOOOXOOOOOOOOOOOOOOOOOOOXOOOXOOOOOOOOOOOOOOOOOOOX
XOOOOOOOXOOOXOOOXOOOOOOOOOOOOOOOOOOOXOOOXOOOOOOOOOOOOOOOOOOOX
XOOOOOOOXOOOXOOOXOOOOOOOOOOOOOOOOOOOXOOOXOOOOOOOOOOOOOOOOOOOX
XXXXXOOOXOOOXOOOXXXXXXXXXOOOXXXXXXXXXOOOXXXXXOOOXXXXXXXXXXXXX
XOOOXOOOOOOOXOOOOOOOXOOOOOOOXOOOOOOOOOOOOOOOOOOOXOOOXOOOXOOOX
XOOOXOOOOOOOXOOOOOOOXOOOOOOOXOOOOOOOOOOOOOOOOOOOXOOOXOOOXOOOX
XOOOXOOOOOOOXOOOOOOOXOOOOOOOXOOOOOOOOOOOOOOOOOOOXOOOXOOOXOOOX
XOOOXXXXXOOOXOOOXXXXXXXXXOOOXOOOXXXXXXXXXXXXXXXXXOOOXOOOXOOOX
XOOOOOOOOOOOXOOOXOOOXOOOXOOOOOOOXOOOXOOOOOOOXOOOOOOOXOOOXOOOX
XOOOOOOOOOOOXOOOXOOOXOOOXOOOOOOOXOOOXOOOOOOOXOOOOOOOXOOOXOOOX
XOOOOOOOOOOOXOOOXOOOXOOOXOOOOOOOXOOOXOOOOOOOXOOOOOOOXOOOXOOOX
XXXXXXXXXOOOXOOOXOOOXOOOXOOOXXXXXOOOXOOOXXXXXOOOXXXXXOOOXOOOX
XOOOXOOOOOOOOOOOOOOOOOOOOOOOOOOOOOOOXOOOOOOOOOOOXOOOOOOOXOOOX
XOOOXOOOOOOOOOOOOOOOOOOOOOOOOOOOOOOOXOOOOOOOOOOOXOOOOOOOXOOOX
XOOOXOOOOOOOOOOOOOOOOOOOOOOOOOOOOOOOXOOOOOOOOOOOXOOOOOOOXOOOX
XOOOXXXXXXXXXXXXXXXXXXXXXOOOXXXXXXXXXOOOXXXXXXXXXOOOXXXXXOOOX
XOOOOOOOOOOOOOOOOOOOOOOOOOOOOOOOOOOOXOOOOOOOOOOOXOOOXOOOXOOOX
XOOOOOOOOOOOOOOOOOOOOOOOOOOOOOOOOOOOXOOOOOOOOOOOXOOOXOOOXOOOX
XOOOOOOOOOOOOOOOOOOOOOOOOOOOOOOOOOOOXOOOOOOOOOOOXOOOXOOOXOOOX
XOOOXXXXXXXXXXXXXXXXXOOOXXXXXXXXXXXXXOOOXXXXXXXXXOOOXOOOXOOOX
XOOOXOOOOOOOOOOOOOOOOOOOOOOOOOOOOOOOOOOOOOOOOOOOOOOOOOOOOOOOX
XOOOXOOOOOOOOOOOOOOOOOOOOOOOOOOOOOOOOOOOOOOOOOOOOOOOOOOOOOOOX
XOOOXOOOOOOOOOOOOOOOOOOOOOOOOOOOOOOOOOOOOOOOOOOOOOOOOOOOOOOOX
XXXXXXXXXXXXXXXXXXXXXXXXXXXXXXXXXXXXXXXXXXXXXXXXXXXXXXXXXXXXX
