XXXXXXXXXXXXXXXXXXXXXXXXXXXXXXXXXXXXXXXXX
XOOOOOOOXOOOOOXOOOOOOOOOOOOOOOXOOOOOOOOOX
XOXXXXXOXXXXXOXXXOXOXOXXXOXXXXXOXXXXXOXXX
XOXOOOOOOOOOOOOOOOXOXOOOXOOOOOOOOOXOXOXOX
XXXXXOXOXXXOXXXOXOXOXOXOXXXOXXXOXXXOXXXOX
XOOOOOXOXOOOXOOOXOXOXOXOOOXOOOXOOOOOOOOOX
XOXXXOXOXOXOXOXXXXXOXOXXXXXOXXXXXXXXXXXXX
XOXOOOXOXOXOXOXOOOXOXOXOOOXOOOOOOOOOXOOOX
XOXOXOXXXOXXXOXXXOXXXOXOXOXXXXXOXXXXXOXXX
XOXOXOXOOOXOOOXOOOOOOOOOXOOOOOXOOOOOOOOOX
XXXOXXXOXXXOXXXXXOXXXOXOXOXXXOXXXOXOXOXXX
XOOOOOXOXOOOXOOOOOXOOOXOXOOOXOOOXOXOXOOOX
XXXOXOXXXXXXXOXOXXXOXOXOXXXOXOXXXOXOXXXXX
XOOOXOOOXOOOOOXOXOOOXOXOXOXOXOOOXOXOXOOOX
XOXOXOXOXOXXXXXXXOXOXOXOXOXOXXXXXXXXXOXXX
XOXOXOXOXOXOOOOOOOXOXOXOOOXOOOOOOOOOOOOOX
XOXOXOXOXXXXXOXXXOXOXXXOXOXXXOXOXXXOXOXXX
XOXOXOXOXOOOOOXOOOXOXOOOXOXOOOXOOOXOXOOOX
XOXOXOXXXXXOXOXXXOXOXOXXXOXXXOXOXXXXXXXXX
XOXOXOXOXOOOXOXOOOXOXOOOXOXOOOXOOOOOOOOOX
XOXOXXXOXOXOXXXOXOXOXOXOXOXOXOXXXXXXXOXXX
XOXOXOOOOOXOOOXOXOXOXOXOXOXOXOOOOOOOXOOOX
XXXOXOXOXOXXXOXXXOXOXOXOXOXOXOXOXOXXXXXXX
XOOOXOXOXOOOXOXOOOXOXOXOXOXOXOXOXOOOOOOOX
XOXOXOXXXOXOXXXXXXXXXOXXXXXXXOXOXXXXXXXOX
XOXOXOOOXOXOXOOOOOOOOOXOXOOOXOXOOOOOOOXOX
XOXXXOXOXXXOXOXOXOXOXOXOXXXOXXXOXXXXXOXOX
XOXOOOXOXOOOXOXOXOXOXOXOOOOOOOOOOOOOXOXOX
XOXXXOXXXOXXXXXXXXXOXOXOXOXXXXXXXOXXXXXXX
XOXOOOOOXOXOOOOOOOOOXOXOXOOOXOOOOOXOOOOOX
XOXOXOXXXXXXXOXXXXXOXOXOXOXXXOXXXOXOXXXOX
XOXOXOOOXOOOXOOOXOOOXOXOXOXOOOXOOOOOOOXOX
XOXXXOXXXXXOXXXXXOXOXXXOXOXOXOXXXOXOXOXXX
XOXOXOXOOOOOOOOOOOXOOOXOXOXOXOXOOOXOXOOOX
XOXOXXXXXOXOXOXXXXXOXOXOXXXXXOXOXOXXXOXOX
XOXOOOXOOOXOXOOOXOOOXOXOXOOOOOXOXOOOXOXOX
XOXXXOXXXXXXXOXXXXXOXXXOXOXXXXXOXXXOXOXOX
XOXOOOXOOOOOXOXOXOOOXOOOXOXOOOOOOOXOXOXOX
XOXXXOXOXOXOXOXOXXXOXOXOXXXOXOXOXXXOXXXOX
XOXOOOOOXOXOOOXOOOOOXOXOXOOOXOXOOOXOXOOOX
XXXXXXXXXXXXXXXXXXXXXXXXXXXXXXXXXXXXXXXXX
