S= 2
XXXXXXXXXXXXXXXXXXXXXXXXXXXXXXXXXXXXXXXXXXXXXXXXXXXXXXXXXXXXX
XOOXOOOOOOOOOOOOOOOOOOOOXOOOOOXOOXOOOOOOOOXOOOOOOOOOOOOOOOOOX
XOOXOOOOOOOOOOOOOOOOOOOOXOOOOOXOOXOOOOOOOOXOOOOOOOOOOOOOOOOOX
XOOXXXXXXXXXXOOXXXXXXXOOXXXXOOXOOXXXXXXXOOXXXXXXXXXXXXXOOXOOX
XOOXOOOOOOOOOOOXOOOOOOOOXOOXOOOOOOOOXOOOOOOOOXOOOOOOOOOOOXOOX
XOOXOOOOOOOOOOOXOOOOOOOOXOOXOOOOOOOOXOOOOOOOOXOOOOOOOOOOOXOOX
XOOXXXXXXXXXXXXXXXXXXXOOXOOXOOXXXXOOXXXXXXXOOXXXXXXXXXXXXXOOX
XOOXOOXOOOOOOOOOOOOOOOOOOOOOOOOOOXOOOOOOOOXOOOOOOOOOOOOOOOOOX
XOOXOOXOOOOOOOOOOOOOOOOOOOOOOOOOOXOOOOOOOOXOOOOOOOOOOOOOOOOOX
XOOXOOXXXXOOXOOXXXXXXXXXXXXXOOXOOXXXXXXXOOXXXXXXXXXXXXXXXXOOX
XOOOOOOOOOOOXOOXOOXOOOOOOOOOOOXOOXOOOOOOOOXOOXOOXOOOOOOOOOOOX
XOOOOOOOOOOOXOOXOOXOOOOOOOOOOOXOOXOOOOOOOOXOOXOOXOOOOOOOOOOOX
XOOXOOXXXXOOXXXXOOXXXXXXXOOXXXXXXXXXXXXXOOXOOXOOXXXXXXXOOXOOX
XOOXOOXOOXOOOOOXOOXOOOOOXOOXOOOOOOOOOOOOOOOOOOOOOOOOOOOOOXOOX
XOOXOOXOOXOOOOOXOOXOOOOOXOOXOOOOOOOOOOOOOOOOOOOOOOOOOOOOOXOOX
XOOXXXXOOXXXXXXXOOXXXXOOXOOXXXXOOXXXXXXXOOXXXXXXXOOXXXXOOXOOX
XOOXOOOOOOOOOOOOOOXOOOOOXOOXOOOOOXOOXOOOOOXOOOOOOOOXOOOOOXOOX
XOOXOOOOOOOOOOOOOOXOOOOOXOOXOOOOOXOOXOOOOOXOOOOOOOOXOOOOOXOOX
XOOXOOXXXXXXXXXXOOXXXXOOXXXXXXXXXXOOXXXXOOXXXXOOXXXXOOXOOXXXX
XOOXOOXOOOOOOOOXOOOOOXOOOOOOOOOOOOOOOOOOOOXOOOOOXOOOOOXOOOOOX
XOOXOOXOOOOOOOOXOOOOOXOOOOOOOOOOOOOOOOOOOOXOOOOOXOOOOOXOOOOOX
XXXXXXXXXXOOXOOXXXXOOXXXXXXXOOXXXXXXXXXXOOXXXXXXXOOXXXXOOXXXX
XOOOOOOOOOOOXOOOOOXOOOOOOOOOOOXOOOOOOOOOOOXOOOOOOOOXOOOOOOOOX
XOOOOOOOOOOOXOOOOOXOOOOOOOOOOOXOOOOOOOOOOOXOOOOOOOOXOOOOOOOOX
XOOXXXXXXXXXXXXXOOXOOXXXXXXXOOXXXXOOXXXXOOXXXXXXXOOXOOXXXXOOX
XOOXOOOOOOOOOOOOOOXOOXOOOOOOOOXOOOOOXOOOOOXOOOOOOOOXOOXOOOOOX
XOOXOOOOOOOOOOOOOOXOOXOOOOOOOOXOOOOOXOOOOOXOOOOOOOOXOOXOOOOOX
XXXXXXXXXXXXXXXXOOXOOXXXXXXXXXXXXXOOXOOXOOXOOXXXXOOXXXXOOXXXX
XOOOOOOOOOOOOOOOOOOOOXOOOOOOOOOOOOOOXOOXOOXOOXOOOOOXOOOOOOOOX
XOOOOOOOOOOOOOOOOOOOOXOOOOOOOOOOOOOOXOOXOOXOOXOOOOOXOOOOOOOOX
XXXXXXXXXXXXXXXXOOXOOXXXXXXXXXXOOXOOXXXXXXXXXXXXXOOXOOXXXXOOX
XOOXOOXOOXOOOOOOOOXOOXOOOOOOOOOOOXOOXOOXOOOOOOOOOOOXOOOOOXOOX
XOOXOOXOOXOOOOOOOOXOOXOOOOOOOOOOOXOOXOOXOOOOOOOOOOOXOOOOOXOOX
XOOXOOXOOXXXXOOXXXXXXXXXXOOXOOXXXXOOXOOXXXXXXXOOXOOXXXXOOXXXX
XOOOOOOOOOOOOOOXOOOOOOOOOOOXOOXOOXOOXOOOOOOOOOOOXOOXOOOOOOOOX
XOOOOOOOOOOOOOOXOOOOOOOOOOOXOOXOOXOOXOOOOOOOOOOOXOOXOOOOOOOOX
XXXXOOXXXXXXXXXXXXXOOXXXXXXXOOXOOXOOXOOXOOXOOXOOXOOXOOXOOXOOX
XOOOOOXOOOOOOOOOOOOOOOOOXOOOOOXOOXOOXOOXOOXOOXOOXOOXOOXOOXOOX
XOOOOOXOOOOOOOOOOOOOOOOOXOOOOOXOOXOOXOOXOOXOOXOOXOOXOOXOOXOOX
XOOXXXXXXXXXXXXXOOXXXXXXXXXXXXXOOXOOXXXXXXXOOXOOXXXXOOXOOXXXX
XOOXOOOOOOOOOOOOOOXOOXOOXOOXOOOOOOOOOOOOOOXOOXOOXOOOOOXOOOOOX
XOOXOOOOOOOOOOOOOOXOOXOOXOOXOOOOOOOOOOOOOOXOOXOOXOOOOOXOOOOOX
XXXXOOXXXXXXXXXXOOXOOXOOXOOXXXXOOXOOXOOXXXXOOXXXXXXXOOXOOXOOX
XOOOOOXOOOOOOOOOOOXOOOOOOOOOOOOOOXOOXOOXOOOOOXOOOOOOOOXOOXOOX
XOOOOOXOOOOOOOOOOOXOOOOOOOOOOOOOOXOOXOOXOOOOOXOOOOOOOOXOOXOOX
XXXXOOXXXXXXXXXXXXXXXXXXXOOXOOXOOXOOXOOXXXXOOXXXXOOXXXXOOXOOX
XOOOOOXOOOOOOOOOOOOOOOOOOOOXOOXOOXOOXOOXOOOOOXOOOOOXOOOOOXOOX
XOOOOOXOOOOOOOOOOOOOOOOOOOOXOOXOOXOOXOOXOOOOOXOOOOOXOOOOOXOOX
XOOXXXXOOXOOXOOXXXXOOXXXXXXXOOXOOXXXXOOXOOXOOXXXXOOXXXXOOXOOX
XOOXOOOOOXOOXOOXOOOOOXOOOOOOOOXOOOOOXOOXOOXOOXOOOOOOOOXOOXOOX
XOOXOOOOOXOOXOOXOOOOOXOOOOOOOOXOOOOOXOOXOOXOOXOOOOOOOOXOOXOOX
XXXXXXXXXXXXXXXXXXXOOXXXXXXXOOXOOXOOXXXXOOXOOXOOXOOXOOXXXXOOX
XOOOOOOOOOOOOOOOOOXOOXOOOOOOOOXOOXOOOOOXOOXOOXOOXOOXOOOOOXOOX
XOOOOOOOOOOOOOOOOOXOOXOOOOOOOOXOOXOOOOOXOOXOOXOOXOOXOOOOOXOOX
XXXXXXXXXXXXXXXXOOXOOXXXXOOXOOXOOXOOXOOXXXXOOXXXXOOXOOXXXXXXX
XOOOOOOOOOOOOOOOOOOOOXOOOOOXOOXOOXOOXOOXOOOOOXOOOOOXOOOOOOOOX
XOOOOOOOOOOOOOOOOOOOOXOOOOOXOOXOOXOOXOOXOOOOOXOOOOOXOOOOOOOOX
XOOXXXXXXXXXXXXXOOXOOXOOXOOXXXXXXXXXXXXXXXXOOXOOXXXXXXXXXXXXX
XOOXOOOOOOOOOOOOOOXOOXOOXOOXOOOOOOOOOOOOOOOOOXOOOOOOOOOOOOOOX
XOOXOOOOOOOOOOOOOOXOOXOOXOOXOOOOOOOOOOOOOOOOOXOOOOOOOOOOOOOOX
XXXXXXXXXXXXXXXXXXXXXXXXXXXXXXXXXXXXXXXXXXXXXXXXXXXXXXXXXXXXX
