S= 3
XXXXXXXXXXXXXXXXXXXXXXXXXXXXXXXXXXXXXXXXXXXXXXXXXXXXXXXXXXXXXXXXXXXXXXXXXXXXXXXXX
XOOOXOOOOOOOXOOOOOOOOOOOXOOOXOOOXOOOOOOOXOOOXOOOOOOOOOOOOOOOOOOOOOOOOOOOOOOOOOOOX
XOOOXOOOOOOOXOOOOOOOOOOOXOOOXOOOXOOOOOOOXOOOXOOOOOOOOOOOOOOOOOOOOOOOOOOOOOOOOOOOX
XOOOXOOOOOOOXOOOOOOOOOOOXOOOXOOOXOOOOOOOXOOOXOOOOOOOOOOOOOOOOOOOOOOOOOOOOOOOOOOOX
XOOOXXXXXOOOXOOOXXXXXXXXXOOOXOOOXXXXXOOOXOOOXOOOXXXXXOOOXXXXXXXXXOOOXXXXXOOOXXXXX
XOOOXOOOOOOOXOOOOOOOOOOOXOOOOOOOXOOOXOOOXOOOOOOOOOOOXOOOOOOOOOOOXOOOOOOOXOOOOOOOX
XOOOXOOOOOOOXOOOOOOOOOOOXOOOOOOOXOOOXOOOXOOOOOOOOOOOXOOOOOOOOOOOXOOOOOOOXOOOOOOOX
XOOOXOOOOOOOXOOOOOOOOOOOXOOOOOOOXOOOXOOOXOOOOOOOOOOOXOOOOOOOOOOOXOOOOOOOXOOOOOOOX
XOOOXXXXXOOOXOOOXXXXXXXXXXXXXOOOXOOOXOOOXOOOXXXXXXXXXXXXXXXXXXXXXOOOXXXXXOOOXXXXX
XOOOOOOOXOOOOOOOXOOOXOOOOOOOOOOOOOOOOOOOXOOOOOOOOOOOOOOOOOOOXOOOOOOOOOOOXOOOOOOOX
XOOOOOOOXOOOOOOOXOOOXOOOOOOOOOOOOOOOOOOOXOOOOOOOOOOOOOOOOOOOXOOOOOOOOOOOXOOOOOOOX
XOOOOOOOXOOOOOOOXOOOXOOOOOOOOOOOOOOOOOOOXOOOOOOOOOOOOOOOOOOOXOOOOOOOOOOOXOOOOOOOX
XXXXXOOOXXXXXOOOXOOOXXXXXXXXXXXXXOOOXXXXXOOOXXXXXXXXXOOOXXXXXXXXXXXXXOOOXOOOXOOOX
XOOOXOOOXOOOXOOOOOOOOOOOXOOOXOOOXOOOXOOOXOOOOOOOOOOOXOOOXOOOOOOOOOOOXOOOXOOOXOOOX
XOOOXOOOXOOOXOOOOOOOOOOOXOOOXOOOXOOOXOOOXOOOOOOOOOOOXOOOXOOOOOOOOOOOXOOOXOOOXOOOX
XOOOXOOOXOOOXOOOOOOOOOOOXOOOXOOOXOOOXOOOXOOOOOOOOOOOXOOOXOOOOOOOOOOOXOOOXOOOXOOOX
XOOOXOOOXOOOXOOOXXXXXXXXXOOOXOOOXOOOXOOOXOOOXXXXXXXXXXXXXOOOXXXXXXXXXXXXXOOOXOOOX
XOOOXOOOXOOOOOOOXOOOXOOOXOOOOOOOXOOOXOOOOOOOOOOOOOOOOOOOOOOOXOOOOOOOXOOOXOOOXOOOX
XOOOXOOOXOOOOOOOXOOOXOOOXOOOOOOOXOOOXOOOOOOOOOOOOOOOOOOOOOOOXOOOOOOOXOOOXOOOXOOOX
XOOOXOOOXOOOOOOOXOOOXOOOXOOOOOOOXOOOXOOOOOOOOOOOOOOOOOOOOOOOXOOOOOOOXOOOXOOOXOOOX
XOOOXOOOXXXXXOOOXOOOXOOOXOOOXXXXXOOOXOOOXXXXXXXXXXXXXXXXXXXXXOOOXXXXXOOOXXXXXOOOX
XOOOOOOOOOOOOOOOOOOOOOOOXOOOXOOOOOOOXOOOOOOOXOOOOOOOXOOOXOOOOOOOXOOOOOOOXOOOXOOOX
XOOOOOOOOOOOOOOOOOOOOOOOXOOOXOOOOOOOXOOOOOOOXOOOOOOOXOOOXOOOOOOOXOOOOOOOXOOOXOOOX
XOOOOOOOOOOOOOOOOOOOOOOOXOOOXOOOOOOOXOOOOOOOXOOOOOOOXOOOXOOOOOOOXOOOOOOOXOOOXOOOX
XXXXXXXXXOOOXXXXXXXXXOOOXOOOXOOOXXXXXOOOXXXXXOOOXXXXXOOOXOOOXXXXXOOOXXXXXOOOXOOOX
XOOOOOOOOOOOXOOOOOOOOOOOOOOOOOOOOOOOOOOOOOOOOOOOOOOOXOOOOOOOOOOOOOOOXOOOOOOOXOOOX
XOOOOOOOOOOOXOOOOOOOOOOOOOOOOOOOOOOOOOOOOOOOOOOOOOOOXOOOOOOOOOOOOOOOXOOOOOOOXOOOX
XOOOOOOOOOOOXOOOOOOOOOOOOOOOOOOOOOOOOOOOOOOOOOOOOOOOXOOOOOOOOOOOOOOOXOOOOOOOXOOOX
XXXXXOOOXOOOXOOOXOOOXOOOXOOOXOOOXXXXXXXXXXXXXXXXXXXXXOOOXXXXXXXXXXXXXOOOXXXXXOOOX
XOOOOOOOXOOOXOOOXOOOXOOOXOOOXOOOOOOOOOOOOOOOOOOOOOOOOOOOOOOOOOOOOOOOOOOOXOOOXOOOX
XOOOOOOOXOOOXOOOXOOOXOOOXOOOXOOOOOOOOOOOOOOOOOOOOOOOOOOOOOOOOOOOOOOOOOOOXOOOXOOOX
XOOOOOOOXOOOXOOOXOOOXOOOXOOOXOOOOOOOOOOOOOOOOOOOOOOOOOOOOOOOOOOOOOOOOOOOXOOOXOOOX
XOOOXOOOXOOOXXXXXXXXXOOOXOOOXXXXXOOOXOOOXOOOXOOOXOOOXOOOXXXXXOOOXXXXXXXXXOOOXOOOX
XOOOXOOOXOOOXOOOXOOOOOOOXOOOOOOOXOOOXOOOXOOOXOOOXOOOXOOOXOOOXOOOOOOOOOOOOOOOXOOOX
XOOOXOOOXOOOXOOOXOOOOOOOXOOOOOOOXOOOXOOOXOOOXOOOXOOOXOOOXOOOXOOOOOOOOOOOOOOOXOOOX
XOOOXOOOXOOOXOOOXOOOOOOOXOOOOOOOXOOOXOOOXOOOXOOOXOOOXOOOXOOOXOOOOOOOOOOOOOOOXOOOX
XOOOXXXXXOOOXOOOXOOOXXXXXOOOXOOOXOOOXXXXXOOOXXXXXXXXXXXXXOOOXXXXXXXXXOOOXXXXXXXXX
XOOOOOOOXOOOXOOOOOOOXOOOOOOOXOOOXOOOOOOOXOOOOOOOOOOOOOOOOOOOOOOOOOOOXOOOXOOOOOOOX
XOOOOOOOXOOOXOOOOOOOXOOOOOOOXOOOXOOOOOOOXOOOOOOOOOOOOOOOOOOOOOOOOOOOXOOOXOOOOOOOX
XOOOOOOOXOOOXOOOOOOOXOOOOOOOXOOOXOOOOOOOXOOOOOOOOOOOOOOOOOOOOOOOOOOOXOOOXOOOOOOOX
XOOOXOOOXOOOXOOOXOOOXOOOXOOOXOOOXOOOXXXXXOOOXXXXXXXXXXXXXOOOXXXXXXXXXOOOXOOOXXXXX
XOOOXOOOXOOOXOOOXOOOXOOOXOOOXOOOXOOOOOOOXOOOOOOOOOOOOOOOXOOOOOOOOOOOXOOOOOOOXOOOX
XOOOXOOOXOOOXOOOXOOOXOOOXOOOXOOOXOOOOOOOXOOOOOOOOOOOOOOOXOOOOOOOOOOOXOOOOOOOXOOOX
XOOOXOOOXOOOXOOOXOOOXOOOXOOOXOOOXOOOOOOOXOOOOOOOOOOOOOOOXOOOOOOOOOOOXOOOOOOOXOOOX
XOOOXXXXXXXXXOOOXXXXXOOOXXXXXOOOXXXXXOOOXXXXXXXXXXXXXXXXXXXXXXXXXXXXXXXXXXXXXOOOX
XOOOOOOOXOOOOOOOXOOOOOOOOOOOXOOOOOOOXOOOOOOOOOOOOOOOOOOOOOOOOOOOXOOOOOOOOOOOXOOOX
XOOOOOOOXOOOOOOOXOOOOOOOOOOOXOOOOOOOXOOOOOOOOOOOOOOOOOOOOOOOOOOOXOOOOOOOOOOOXOOOX
XOOOOOOOXOOOOOOOXOOOOOOOOOOOXOOOOOOOXOOOOOOOOOOOOOOOOOOOOOOOOOOOXOOOOOOOOOOOXOOOX
XOOOXXXXXOOOXXXXXOOOXOOOXXXXXOOOXOOOXXXXXOOOXOOOXXXXXXXXXOOOXXXXXOOOXXXXXOOOXOOOX
XOOOXOOOOOOOXOOOOOOOXOOOXOOOOOOOXOOOXOOOOOOOXOOOOOOOXOOOOOOOOOOOOOOOOOOOXOOOOOOOX
XOOOXOOOOOOOXOOOOOOOXOOOXOOOOOOOXOOOXOOOOOOOXOOOOOOOXOOOOOOOOOOOOOOOOOOOXOOOOOOOX
XOOOXOOOOOOOXOOOOOOOXOOOXOOOOOOOXOOOXOOOOOOOXOOOOOOOXOOOOOOOOOOOOOOOOOOOXOOOOOOOX
XOOOXXXXXOOOXOOOXXXXXOOOXOOOXOOOXOOOXOOOXOOOXOOOXOOOXXXXXOOOXOOOXOOOXXXXXOOOXOOOX
XOOOXOOOOOOOXOOOXOOOOOOOXOOOXOOOXOOOXOOOXOOOXOOOXOOOOOOOXOOOXOOOXOOOXOOOXOOOXOOOX
XOOOXOOOOOOOXOOOXOOOOOOOXOOOXOOOXOOOXOOOXOOOXOOOXOOOOOOOXOOOXOOOXOOOXOOOXOOOXOOOX
XOOOXOOOOOOOXOOOXOOOOOOOXOOOXOOOXOOOXOOOXOOOXOOOXOOOOOOOXOOOXOOOXOOOXOOOXOOOXOOOX
XXXXXXXXXOOOXXXXXXXXXOOOXOOOXXXXXOOOXXXXXXXXXOOOXXXXXXXXXXXXXOOOXXXXXOOOXOOOXXXXX
XOOOOOOOOOOOXOOOOOOOOOOOXOOOXOOOOOOOOOOOOOOOXOOOOOOOOOOOOOOOXOOOOOOOOOOOXOOOOOOOX
XOOOOOOOOOOOXOOOOOOOOOOOXOOOXOOOOOOOOOOOOOOOXOOOOOOOOOOOOOOOXOOOOOOOOOOOXOOOOOOOX
XOOOOOOOOOOOXOOOOOOOOOOOXOOOXOOOOOOOOOOOOOOOXOOOOOOOOOOOOOOOXOOOOOOOOOOOXOOOOOOOX
XXXXXXXXXOOOXXXXXOOOXOOOXOOOXXXXXOOOXXXXXOOOXXXXXOOOXOOOXXXXXOOOXOOOXXXXXOOOXOOOX
XOOOOOOOOOOOXOOOOOOOXOOOXOOOXOOOOOOOOOOOXOOOXOOOOOOOXOOOXOOOOOOOXOOOOOOOXOOOXOOOX
XOOOOOOOOOOOXOOOOOOOXOOOXOOOXOOOOOOOOOOOXOOOXOOOOOOOXOOOXOOOOOOOXOOOOOOOXOOOXOOOX
XOOOOOOOOOOOXOOOOOOOXOOOXOOOXOOOOOOOOOOOXOOOXOOOOOOOXOOOXOOOOOOOXOOOOOOOXOOOXOOOX
XOOOXOOOXOOOXOOOXOOOXXXXXOOOXOOOXOOOXXXXXXXXXXXXXOOOXOOOXXXXXOOOXXXXXXXXXOOOXOOOX
XOOOXOOOXOOOXOOOXOOOXOOOOOOOXOOOXOOOOOOOOOOOOOOOXOOOXOOOXOOOOOOOOOOOOOOOXOOOXOOOX
XOOOXOOOXOOOXOOOXOOOXOOOOOOOXOOOXOOOOOOOOOOOOOOOXOOOXOOOXOOOOOOOOOOOOOOOXOOOXOOOX
XOOOXOOOXOOOXOOOXOOOXOOOOOOOXOOOXOOOOOOOOOOOOOOOXOOOXOOOXOOOOOOOOOOOOOOOXOOOXOOOX
XXXXXOOOXOOOXXXXXOOOXXXXXOOOXXXXXOOOXXXXXXXXXXXXXOOOXOOOXOOOXOOOXXXXXOOOXOOOXOOOX
XOOOOOOOXOOOXOOOOOOOXOOOOOOOXOOOOOOOOOOOOOOOOOOOXOOOXOOOXOOOXOOOOOOOXOOOXOOOXOOOX
XOOOOOOOXOOOXOOOOOOOXOOOOOOOXOOOOOOOOOOOOOOOOOOOXOOOXOOOXOOOXOOOOOOOXOOOXOOOXOOOX
XOOOOOOOXOOOXOOOOOOOXOOOOOOOXOOOOOOOOOOOOOOOOOOOXOOOXOOOXOOOXOOOOOOOXOOOXOOOXOOOX
XOOOXOOOXXXXXOOOXOOOXOOOXOOOXOOOXOOOXOOOXOOOXOOOXXXXXXXXXOOOXXXXXOOOXOOOXXXXXOOOX
XOOOXOOOOOOOXOOOXOOOXOOOXOOOXOOOXOOOXOOOXOOOXOOOOOOOOOOOXOOOOOOOXOOOXOOOOOOOXOOOX
XOOOXOOOOOOOXOOOXOOOXOOOXOOOXOOOXOOOXOOOXOOOXOOOOOOOOOOOXOOOOOOOXOOOXOOOOOOOXOOOX
XOOOXOOOOOOOXOOOXOOOXOOOXOOOXOOOXOOOXOOOXOOOXOOOOOOOOOOOXOOOOOOOXOOOXOOOOOOOXOOOX
XOOOXOOOXOOOXXXXXXXXXOOOXOOOXOOOXXXXXOOOXXXXXXXXXXXXXOOOXOOOXXXXXXXXXXXXXOOOXOOOX
XOOOXOOOXOOOXOOOOOOOOOOOXOOOXOOOOOOOXOOOOOOOOOOOOOOOXOOOXOOOXOOOOOOOOOOOOOOOXOOOX
XOOOXOOOXOOOXOOOOOOOOOOOXOOOXOOOOOOOXOOOOOOOOOOOOOOOXOOOXOOOXOOOOOOOOOOOOOOOXOOOX
XOOOXOOOXOOOXOOOOOOOOOOOXOOOXOOOOOOOXOOOOOOOOOOOOOOOXOOOXOOOXOOOOOOOOOOOOOOOXOOOX
XXXXXXXXXXXXXXXXXXXXXXXXXXXXXXXXXXXXXXXXXXXXXXXXXXXXXXXXXXXXXXXXXXXXXXXXXXXXXXXXX
